1100001222
1112200220
1122200002
1112220330
1222203300
0220001300
0000010100
0332001000
0332200010
0030000100